6-Mar,321
7-Mar,321
8-Mar,321
9-Mar,321
10-Mar,321
11-Mar,321
12-Mar,321
13-Mar,321
14-Mar,321
15-Mar,321
